QQQQQQQQQQQQQQQQQQQQ
Q....OOOOOOOOOOOOOOQ
Q OOOOO          OOQ
Q O    OOOOOOOOO  OQ
Q O OOOO  OV O O  OQ
Q OT      O  O O   Q
Q OOOO OOOO  O O O Q
Q O  O O  O     TO Q
Q    O O  O OOOOOO Q
QOOOOO O    O   ..OQ
Q..  O O OOOO..OOOOQ
QQQQQQQQQQQQQQQQQQQQ